0000000000000000000000000000222222222222200000000000000000000000000000000000000000000000000000000000
0000011111100000011111111111200000000000222220000000000000000000000000000000000000000000000000000000
0000010000100000010000000000200000000000200020000000000000000000000000000000000000000000000000000000
0000010000100000010000000000000000000000000020000000000000000000000000000000000000000000000000000000
0000010000010000010000000000200000000000200020000000000000000000000000000000000000000000000000000000
0000011111111111010001111111200000000000222220000000000000000000000000000000000000000000000000000000
0000010000000001010001000000200000000000200000000000000000000000000000000000000000000000000000000000
0000010000000001110001110000022222022222200000000000000000000000000000000000000000000000000000000000
0000010000000001000000010000000020002000000000000000000000000000000000000000000000000000000000000000
0000010000000001000000010000000020002000000000000000000000000000000000000000000000000000000000000000
0000010000000000000000010000000020002000000000000000000000000000000000000000000000000000000000000000
0000010000000001111111110000000020002000000000000000000000000000000000000000000000000000000000000000
1111110000000001000000000000000020002000000000000000000000000000000000000000000000000000000000000000
1000110000000001000000000002222220002220000000000000000000000000000000000000000000000000000000000000
1000110000000001000000000002000000000020000000000000000000000000000000000000000000000000000000000000
1000111111011110000000000002000020002220000000000000000000000000000000000000000000000000000000000000
1101100010001000000000000002000020002000000000000000000000000000000000000000000000000000000000000000
1000100010001000000000000002000020002000000000000000000000000000000000000000000000000000000000000000
1000111110001000000000000002222220002000000000000000000000000000000000000000000000000000000000000000
1000100010001000000000000000000020002000000000000000000000000000000000000000000000000000000000000000
1000000010001000000000000000000022022000000000000000033333333330000000000000000000000000000000000000
1000100010001000000000000011111100000111111100000000030000000030000000000000000000000000000000000000
1000100010001000000000000010000000000000001100000000030000000030000000000000000000000000000000000000
1000111111011111000000000010000000000000001333333333330000000030000000000000000000000000000000000000
1000110000000001000000000010000000000000000300000000030000000030000000000000000000000000000000000000
1000110000000001000000000010000000000000000000000000000000000030000000000000000000000000000000000000
1000010000000001000000000010000000000000000300000000030000000030000000000000000000000000000000000000
1000000000000001000000000010000000000000001333000033330000000030000000000000000000000000000000000000
1000010000000001000000000010000000000000001113300300030000000030000000000000000000000000000000000000
1000110000000001000000000011111100000111111000300300030000000030000000000000000000000000000000000000
1000110000000001000000000000000133033000000000300300033303303330000000000000000000000000000000000000
1000110000000001000000000000000030003000000000300300000030030000000000000000000000000000000000000000
1000110000000001000000000000000030003000000000300300000000000000000000000000000000000000000000000000
1000111111011111000000000000000030003000000000300300303030000000000000000000000000000000000000000000
1000111110001000000000000000000030003000000000300333030303033000000000000000000000000000000000000000
1000100010001000000000000000000030003000000000300030000000003000000000000000000000000000000000000000
1000000010001000000000000000000030003000000000300000000000003000000000000000000000000000000000000000
1000100010001000000000000000000030003000000000300030000000003000000000000000000000000000000000000000
1000111110001000000000000000000030003000000000333333030303033000000000000000000000000000000000000000
1000111110001111111111111100000030003000000000000000000000000000000000000000000000000000000000000000
1000000000000000001000000111000030003000000000000000000000000000000000000000000000000000000000000000
1000000000000000000000000101000030003000000000000000000000000000000000000000000000000000000000000000
1000000000000000001000000111000030003000000000000000000000000000000000000000000000000000000000000000
1111111111111111111111111100000030003000000000000000000000000000000000000000000000000000000000000000
0000000000011001001001000000333333033333330000000000000000000000000000000000000000000000000000000000
0000000000110001001010000000300030003000030000000000000000000000000000000000000000000000000000000000
0000000000011000001100000000300000000000030000000000000000000000000000000000000000000000000000000000
0000000000000111111000000000300030003000030000000000000000000000000000000000000000000000000000000000
0000000000000100100000000000300030003000030000000000000000000000000000000000000000000000000000000000
0000000000000100100000000000300030003000030000000000000000000000000000000000000000000000000000000000
0000000000000111100000000000333330003333330000000000000000000000000000000000000000000000000000000000
0000000000000000000000000000300030003000030000000000000000000000000000000000000000000000000000000000
0000000000000000000000000000303000000000030000000000000000000000000000000000000000000000000000000000
0000000000000000000000000000300030003000030000000000000000000000000000000000000000000000000000000000
0000000000000000000000000000333330003333330000000000000000000000000000000000000000000000000000000000
0000000000000000000000000000300000000000030000000000000000000000000000000000000000000000000000000000
0000000000000000000000000000300000000000030000000000000000000000000000000000000000000000000000000000
0000000000000000000000000000300000000000030000000000000000000000000000000000000000000000000000000000
0000000000000000000000000000300000000000030000000000000000000000000000000000000000000000000000000000
0000000000000000000000000000333333333333330000000000000000000000000000000000000000000000000000000000