0000000000000111100000000000333330003333330000000000000000000000000000000000000000000000000000000000
0000000000000000000000000000300030003000030000000000000000000000000000000000000000000000000000000000
0000000000000000000000000000303000000000030000000000000000000000000000000000000000000000000000000000
0000000000000000000000000000300030003000030000000000000000000000000000000000000000000000000000000000
0000000000000000000000000000333330003333330000000000000000000000000000000000000000000000000000000000
0000000000000000000000000000300000000000030000000000000000000000000000000000000000000000000000000000
0000000000000000000000000000300000000000030000000000000000000000000000000000000000000000000000000000
0000000000000000000000000000300000000000030000000000000000000000000000000000000000000000000000000000
0000000000000000000000000000300000000000030000000000000000000000000000000000000000000000000000000000
0000000000000000000000000000333333333333330000000000000000000000000000000000000000000000000000000000